
NO textures/simonkraft/respawn_anchor_side0.xpm
EA   textures/simonkraft/respawn_anchor_side2.xpm
SO            textures/simonkraft/respawn_anchor_side4.xpm
WE    textures/simonkraft/respawn_anchor_side3.xpm

C               35,                19,               73
F    15,6,40

111111111111
1N1000000000
111111111111
 111 111 111 111