NO textures/test/north.xpm
SO textures/test/south.xpm
WE textures/test/west.xpm
EA textures/test/east.xpm

F 20,20,20
C 200,200,200

1111
1001
1001
1001
1001
1001
1001
1001
1111
111
1001
1S01
1111
